##########~#########################################
#######-------#######--@--#################-@-######
#######---&---#######-----#################---######
#######-------########---###################-#######
###########---########---###############-----#######
###########---#######"-----#############-###########
###########---#######--!---#############-###########
############-########------#############-###########
############*########--------------------###########
############-#########---#####-#########-###########
############-#########---#####-#########-###########
############-------------####---########-###########
######################---####-@-######"----#########
######################---#############-----#########
#############------------------------------#########
#############--^--####---#############--?--#########
#############-----####---#############-----#########
#######-@-###--*--####---###########################
#######---#####-######---###########################
#######---#####-######---###########################
#######---------######---###########################
#######################=############################
