################~##################################################
################-##################################################
################-#############-+-##################################
################-############-----#################################
################-###########-------################################
################-##############-###################################
################-##############-#-----------#######################
################-##############-#-----------#######################
################-##############-#-----?-----#######################
################-#####--------#-#-----------#######################
################---------!------------------#######################
######################--------#-#-----------#######################
###############################-###################################
##############################---#####-!-#-!-#-!-#-!-#-!-#-!-######
####################--------#-----####---#---#---#---#---#---######
####################--------#-----#####-###-###-###-###-###-#######
####################----------------------------------------#######
####################--------#-----#####-###-###-###-###-###-#######
####################--------#-----####---#---#---#---#---#---######
######################-######-----####-!-#-!-#-!-#-!-#-!-#-!-######
####################-----####-----#################################
####################--&--####-----#################################
###############################=###################################