################~##################################################
###################################################################
##############################-+-##################################
#############################-----#################################
############################-------################################
###############################-###################################
###############################-#-----------#######################
###############################-#-----------#######################
###############################-#-----?-----#######################
######################--------#-#-----------#######################
######################---!------------------#######################
######################--------#-#-----------#######################
###############################-###################################
##############################---#####-!-#-!-#-!-#-!-#-!-#-!-######
####################--------#-----####---#---#---#---#---#---######
####################--------#-----#####-###-###-###-###-###-#######
####################----------------------------------------#######
####################--------#-----#####-###-###-###-###-###-#######
####################--------#-----####---#---#---#---#---#---######
######################-######-----####-!-#-!-#-!-#-!-#-!-#-!-######
####################-----####-----#################################
####################--&--####-----#################################
###############################=###################################