####################################################
#####-----##############-$-#########################
#####-----##############------------------##########
#####-@-&-----------####---##############*##########
#####-----#########-####***##############-##########
#####-----#########-###-----#############-##########
###################-##-------############-##########
###################------------#######-----+-#######
###################------?------######-------#######
###################-------------######-------#######
###################----------------------!---#######
#########-----------------------######-------#######
#########-#########-------------######-------#######
#########-#########-------------######-------#######
#########-#########-------------#########-##########
#########-#########"-----------"#########-##########
#########-###############-###############-##########
########---##############-###############-##########
########-^--------------------------------##########
########---##############-##########################
#########################-##########################
#########################=##########################