Basement########~##################################################
################-##################################################
################-#############-@-##################################
################-############-@-@-#################################
################-###########@-----@################################
################-##############-###################################
################-----*----#####-#!---------!#######################
################-########-#####-#-----------#######################
################-########-#####-#-----"-----#######################
################-#####-------"#-#-----------#######################
################----!-----------------------#######################
######################--------#-#----------!#######################
###############################-###################################
##############################---#####-!-#-!-#-!-#-?-#-!-#-!-######
####################@------@#-----####---#---#---#---#---#---######
####################--------#-----#####-###-###-###-###-###-###---#
####################"---&----------------------------------------+#
####################--------#-----#####-###-###-###-###-###-###---#
####################@------@#-----####---#---#---#---#---#---######
######################-######-----####-!-#-!-#-!-#-?-#-!-#-!-######
####################-----####-----#################################
####################--+--####-----#################################
###############################=###################################