######~#############################################
######-#############################################
######-##############---@---#############-@-########
######-#############---------############---########
######-#############---------############---########
######-------*---###---------#############-#########
##########-#####-###----!----#############-#########
#########---####-###---------#############-#########
#########-@-####-###---------#############-#########
################-###---------###########-----#######
##------"-######-#######-###############--?--#######
##-@-----------------------------------------#######
##--------######-#######-###############-----#######
################-#######-###############-----#######
################-#######-################-##########
######-----#####-#######-################-##########
######-----#####-######---##############"------#####
######@--^-------------------------------------#####
######-----############---##############-------#####
######-----#############-###############----&--#####
########################-###############-------#####
########################=###########################