##########~#########################################
#######-------#######--@--#################-@-######
#######---&---#######-----#################---######
#######-------########---###################-#######
###########---########---###############-----#######
###########---#######"-----#############-###########
###########---#######--!---#############-###########
############-########------#############-###########
############*########--------------------###########
############-#########---#####-#########-###########
############-#########---#####-#########-###########
############-------------####---########-###########
######################---####-+-######"----#########
######################---#############-----#########
#############----------@-------------------#########
#############--^--####---#############--?--#########
#############-----####---#############----@#########
#######-@-###--*--####---###########################
#######---#####-######---###########################
#######---#####-######---###########################
#######---------######---###########################
#######################=############################