BASEMENT #######~##################################################
################-##################################################
################-#############-@-##################################
################-############-@-@-#################################
################-###########@-----@################################
################-##############-##################%%%%%%%##########
################-----*----#####-#!--@------!######%+%t%"%##########
################-########-#####-#-----------######%%%%%%%##########
################-########-#####-#-----"----@##########%############
################-#####@------"#-#-----------S%%%%%%%%%%############
################----!-----@-----------------#######################
######################@-------#-#----@-----!#######################
###############################-###################################
######-!-#-!-#-!-#-!-#-!-#####---#####-!-#-!-#-!-#-!-#-!-#-!-######
######---#---#---#---#---####@-@-@####---#---#---#---#---#---######
#-!@###-###-###-###-###-#####-----#####-###-###-###-###-###-###@--#
#+---------------------------------------------------------------+#
#-!@###-###-###-###-###-#####-----#####-###-###-###-###-###-###@--#
######---#---#---#---#---####-----####---#---#---#---#---#---######
######-!-#-!-#-?-#-!-#-!-####-----####-!-#-!-#-!-#-?-#-!-#-!-######
#############################-----#################################
#############################--=--#################################
###################################################################