Store    ##########################################################
###################################################################
####################-----------------------########################
##################---------------------------######################
#################-----------------------------#####################
################-------------------------------####################
################-------------------------------####################
################-------------------------------####################
################-------------------------------####################
################-------------------------------####################
################-------------------------------####################
#################-----------------------------#####################
##################---------------------------######################
####################-----------------------########################
##############################---##################################
##############################---##################################
##############################---##################################
############################-------################################
###########################---------###############################
###########################---------###############################
###########################---------###############################
###########################----=----###############################
###############################~###################################